111111111111
1100000111C1
1100000111C1
1000000111C1
1CE0000111C1
1100P00000C1
1100000111C1
111111111111