111111111111111
1C00000000000C1
100000000000001
100000000000001
100PE0000000001
100000000000001
100000000000001
1C00000000000C1
111111111111111