111111111111
1CE0000111C1
1000000000C1
1000P00111C1
111111111111