11111111111
100P0000001
11111111101
10000000001
10111111111
10EC0000000
11111111111